00000000000000000000
00000000000000000000
00000000000000000000
00000000000000000000
00000000000000000000
00000000000000000000
00000000000000000000
00000001111110000000
00000001244410000000
00001111444410000000
00001221113211100000
00001232322332100000
00001523232222100000
00001222111222100000
00001111101111100000
00000000000000000000
00000000000000000000
00000000000000000000
00000000000000000000
00000000000000000000