00000000000000000000
00000000000000000000
00000000000000000000
00000000000000000000
00011111111111100000
00014422122222111000
00014422123223221000
00014422131111221000
00014422225211221000
00014422121223211000
00011111121132321000
00000123223232321000
00000122221222221000
00000111111111111000
00000000000000000000
00000000000000000000
00000000000000000000
00000000000000000000
00000000000000000000
00000000000000000000