00000000000000000000
00000000000000000000
00000000000000000000
00000000000000000000
00000000000000000000
00000001111100000000
00000001251110000000
00000001232210000000
00000011121211000000
00000014121221000000
00000014322121000000
00000014222321000000
00000011111111000000
00000000000000000000
00000000000000000000
00000000000000000000
00000000000000000000
00000000000000000000
00000000000000000000
00000000000000000000