00000000000000000000
00000000000000000000
00000000000000000000
00000000000000000000
00000000000000000000
00000000000000000000
00000001111111100000
00000001222211100000
00000001232222100000
00000111232112100000
00000144423222100000
00000144431321100000
00000111121232100000
00000000122252100000
00000000111111100000
00000000000000000000
00000000000000000000
00000000000000000000
00000000000000000000
00000000000000000000