00000000000000000000
00000000000000000000
00000000000000000000
00000000000000000000
00000000000000000000
00000000000000000000
00000000000000000000
00011111100011111000
00012222111012241000
00012232321014441000
00012122321112241000
00012233322232541000
00011122322312241000
00000122313214441000
00000112222212241000
00000011111111111000
00000000000000000000
00000000000000000000
00000000000000000000
00000000000000000000