00000000000000000000
00000000000000000000
00000000000000000000
00000000000000000000
00000000000000000000
00000000000000000000
00000000001111110000
00000011111422210000
00000012214411210000
00000012234422210000
00000012212412110000
00000111211312210000
00000123222233210000
00000121312212210000
00000152211111110000
00000111110000000000
00000000000000000000
00000000000000000000
00000000000000000000
00000000000000000000