00000000000000000000
00000000000000000000
00000000000000000000
00000000000000000000
00000000000000000000
00000000011111111100
00000000012222222100
00000000012121212100
00000000012232312100
00011111112223222100
00014412211232312100
00014422211232322100
00014412211211111100
00014412123232100000
00014422222322100000
00012211152211100000
00011110111110000000
00000000000000000000
00000000000000000000
00000000000000000000