00000000000000000000
00000000000000000000
00000000000000000000
00000000000000000000
00000000001111000000
00011111111221111000
00012221144444221000
00012232211444121000
00011223221112121000
00001212322122221000
00001221232212221000
00001222123221221000
00001222212321211000
00001111221232210000
00000001122123210000
00000000115122210000
00000000011111110000
00000000000000000000
00000000000000000000
00000000000000000000