00000000000000000000
00000000000000000000
00000000000000000000
00000000111111000000
00000011122221100000
00000012221122100000
00001113112212100000
00011222224412100000
00012231319412100000
00012332514912111000
00012233214412221000
00011222214432221000
00001113114212111000
00000012211122100000
00000011222221100000
00000001111111000000
00000000000000000000
00000000000000000000
00000000000000000000
00000000000000000000