00000000000000000000
00000000000000000000
00000000000000000000
00000000000000000000
00000000000111110000
00000000000122210000
00011111111121210000
00012323232322210000
00012141414123110000
00014444444252100000
00012121212131110000
00012323232322210000
00011111111121210000
00000000000122210000
00000000000111110000
00000000000000000000
00000000000000000000
00000000000000000000
00000000000000000000
00000000000000000000