00000000000000000000
00000000000000000000
00000000000000000000
00000000000000000000
00000000111111000000
00001111122221000000
00001221223231000000
00001222212321110000
00011221221223211000
00012312252122221000
00012222323123321000
00012232134942111000
00011221234441100000
00001111214444100000
00000001224444100000
00000001111111100000
00000000000000000000
00000000000000000000
00000000000000000000
00000000000000000000