00000000000000000000
00000000000000000000
00000000000000000000
00000000000000000000
00000111111111110000
00000123423242210000
00000122122342210000
00000144944191410000
00000133133342310000
00000122435342210000
00000132433313310000
00000141914494410000
00000122432212210000
00000122432342210000
00000111111111110000
00000000000000000000
00000000000000000000
00000000000000000000
00000000000000000000
00000000000000000000