00000000000000000000
00000000000000000000
00000000000000000000
00000000000000000000
00011110000001111000
00014411111111441000
00019494444494941000
00012323232323231000
00013232353232321000
00012323232323231000
00013232323232321000
00014949444449491000
00014411111111441000
00011110000001111000
00000000000000000000
00000000000000000000
00000000000000000000
00000000000000000000
00000000000000000000
00000000000000000000